X X XXX   X XXX X
X  HXXX X X   X X
XXX*FXXFX   X   X
X X XXX   X XXX X
X   XXX X X   X X
XXXH    X   X   X